111111111111111111111
10000C0000C0000000001
10000C0000000000C0001
10000C0000000000C0001
10CC00000E000000CCC01
10C000000P0000CCC0001
1C0000000000000000001
10000C0000C0000000001
111111111111111111111