111111111111111111111
10000C0000C0000000001
10000C0000000000C0001
10000C0001E10000C0001
10CC00K000100000CCC01
10C000000P0000CCC0101
1C0010000000000000101
10000C0000C00000001C1
111111111111111111111