111111111111111111111
11000C0000C0000000011
11000C0000000000C0011
11000C0000000000C0011
11CC00000E000000CCC11
11C000000P0000CCC0011
110000000000000000011
11000C0000C0000000011
111111111111111111111