11111
10EC1
100P1
11111
10001
11111