111111111111111111111
100000001000001000001
100000100000000000001
10K000100001000000001
1KCK000010100010000E1
10K000000P00001000101
1C001000000001C1001C1
100000000000001000101
111111111111111111111
