111111111111111111111
100000001000001000001
100000100000000000001
100000100001000000001
10C000001010001000001
100000000P00001000101
1C001000000001C0001C1
100000000000001000101
111111111111111111111
111111111111111111111
