111111111111111111111
100000001000001000001
100000100000000000001
1000001000E1000000001
10C000000010001000001
10C000000P00001000101
1C0010000000000000101
100000000000000000101
111111111111111111111