111111111111111111111
1K00K0001000001000001
1000K0100000000000001
10K0K01000010000E0001
1KC0K0001K10001000001
10K0K0000P00001000101
1C001000000001C0001C1
100000000000001000101
111111111111111111111